TILEMAP
18 16 							-- Size of tile map in tiles
16 32 							-- Tile size & block size
images/blocks.png 	-- Tilesheet
2 2 								-- Number of tiles in tilesheet
000000000000000000
000000000000000000
000000000000000000
000000000000000000
111111111111111111
1                1
1                1
1                1
1                1
1                1
1                1
1                1
1                1
1                1
111111111111111111
000000000000000000
000000000000000000
000000000000000000

