TILEMAP
35 25 							-- Size of tile map in tiles
16 32 							-- Tile size & block size
images/tileset.png 	-- Tilesheet
64 64 							-- Number of tiles in tilesheet
00000000000000000000000000000000000
00000000000000000000000000000000000
00000000000000000000000000000000000
00000000000000000000000000000000000
11111111111111111111111111111111111
1                                 1
1                                 1
1                                 1
1                                 1
1                                 1
1                                 1
1                                 1
1                                 1
1                                 1
1                                 1
1                                 1
1                                 1
1                                 1
1                                 1
1                                 1
1                                 1
1                                 1
1                                 1
1                                 1
11111111111111111111111111111111111